..............................##.....$..$..$..................$...................................
.................$...^........##....##########....e...###...####..................................
.................######.......##..............########................e....................#######
.........................###..###.........................##.......######..##.............##......
.....................^^..###..###^^^.......#.#....########.........................####...........
..............#.....########..######.....#.....................................##.................
............###.....#..................#...........e....^^######..........e.............^^........
.....@.....####..#####^^^#^^^########.........##################^^###############^^^^^^^##########
:::::::::::::::..::::::::::::::::::::.........::::::::::::::::::::::::::::::::::::::::::::::::::::
:::::::::::::::^^::::::::::::::::::::.........::::::::::::::::::::::::::::::::::::::::::::::::::::
:::::::::::::::::::::::::::::::::::::^^^^^^^^^::::::::::::::::::::::::::::::::::::::::::::::::::::
::::::::::::::::::::::::::::::::::::::::::::::::::::::::::::::::::::::::::::::::::::::::::::::::::
::::::::::::::::::::::::::::::::::::::::::::::::::::::::::::::::::::::::::::::::::::::::::::::::::
::::::::::::::::::::::::::::::::::::::::::::::::::::::::::::::::::::::::::::::::::::::::::::::::::
::::::::::::::::::::::::::::::::::::::::::::::::::::::::::::::::::::::::::::::::::::::::::::::::::
::::::::::::::::::::::::::::::::::::::::::::::::::::::::::::::::::::::::::::::::::::::::::::::::::
::::::::::::::::::::::::::::::::::::::::::::::::::::::::::::::::::::::::::::::::::::::::::::::::::