......||||||||||#######|||||||||||||||||||||||||||||||||||||||||||||||||||||||||||||||||||||||||||
......|..........................................................................................|
......|.......................##.................................................................|
......|.......................##.....$..$..$..................$..................................|
......|..........$...^........##....#########b....e...b##...####...........................B.....|
......|..........######.......##..............########................e....................#######
......|..................###..###.........................##.......b####b..##.............##.....|
......|.......#.....E^^..###..###^^^.......#.#....########.........................####..........|
......|......##.....########..######.....#.....................................##...............o|
......|.....###.....#..................#...........e....^^######..........e.............^^.......|
......|.@.^####.....##^^^#^^^########.........b########b########^^b#############b^^^^^^^##########
:::::::::::::::.....:::::::::::::::::.........::::::::::::::::::::::::::::::::::::::::::::::::::::
:::::::::::::::^^^^^:::::::::::::::::.........::::::::::::::::::::::::::::::::::::::::::::::::::::
:::::::::::::::::::::::::::::::::::::^^^^^^^^^::::::::::::::::::::::::::::::::::::::::::::::::::::
::::::::::::::::::::::::::::::::::::::::::::::::::::::::::::::::::::::::::::::::::::::::::::::::::
::::::::::::::::::::::::::::::::::::::::::::::::::::::::::::::::::::::::::::::::::::::::::::::::::
::::::::::::::::::::::::::::::::::::::::::::::::::::::::::::::::::::::::::::::::::::::::::::::::::
::::::::::::::::::::::::::::::::::::::::::::::::::::::::::::::::::::::::::::::::::::::::::::::::::
::::::::::::::::::::::::::::::::::::::::::::::::::::::::::::::::::::::::::::::::::::::::::::::::::
::::::::::::::::::::::::::::::::::::::::::::::::::::::::::::::::::::::::::::::::::::::::::::::::::
